11111111111100
13300100000111
13300102002001
13300121111001
13377004011001
13300101002011
11111101170201
00102002070201
00100001000001
00111111111111