0000111110000000000000
0000100010000000000000
0000120010000000000000
0011100211100000000000
0010020020100000000000
1110101110100000111111
1000101110111111100331
1020020000000000000331
1111101111014111100331
0000100000011100111111
0000111111110000000000