00111110
11100010
13420010
11107310
13112010
10103011
12052231
10003001
11111111